111111111111111111111111111111
1P0000010000000000000010000001
1000000100000000000000100E0001
1000C0010000000000000010000001
100000010000001000C00010000001
100000010000001000000010000001
10000001000000100000001000C001
10000001000C001000C00010000001
100000010000001000000010000001
100000010000001000000010000001
100000010000001000C00010000001
100000000000001000000000000001
1000000C00000010000000C0000001
100000000000001000000000000001
111111111111111111111111111111