11111111
1P00E0C1
1C0000C1
1000N001
11111111