111111111111111111111111111111
1P0000010000C00000C00010000001
1000000100000000000000100E0001
1000C001000N00000000001000C001
100000010000001000C00010000001
10C0000100C0001000000010000001
10000C01000000100000001000C001
10000001000C001000C00010000001
100000010000001000000010000001
100C000100000010000000100C0001
100000010000001000C00010000001
1000000000C00010C0000000000001
100C000C00000010000000C0000C01
1000000000000C1000C00000000001
111111111111111111111111111111