1111111111111111111111
1P00100000100000100001
100010C10010010010C001
1000100100100100100001
10N01001W010C10010W001
10001C0100100100100001
1C001001001C0100100001
1000100100100100100001
10C000010000010000C0E1
1111111111111111111111
