1111111111111111111111
1P00100C0000000000C001
1000100N00100000000001
1000100000100C00000001
10C000C000111111000C01
10C0C000C0100001000001
10C0C00000100001111111
10C00000C0000001C000E1
1111110001111111000001
1000000000000000000001
1111111111111111111111